70 80
0 0 0 0 0 0 0 0 0 0 0 0 0 0 0 0 0 0 0 0 0 0 0 0 0 0 0 0 0 0 0 0 0 0 0 0 0 0 0 0 0 0 0 0 0 0 0 0 0 0 0 0 0 0 0 0 0 0 0 0 0 0 0 0 0 0 0 0 0 0 
0 0 0 0 0 0 0 0 0 0 0 0 0 0 0 0 0 0 0 0 0 0 0 0 0 0 0 0 0 0 0 0 0 0 0 0 0 0 0 0 0 0 0 0 0 0 0 0 0 0 0 0 0 0 0 0 0 0 0 0 0 0 0 0 0 0 0 0 0 0 
0 0 0 0 0 0 0 0 0 0 0 0 0 0 52 0 0 0 0 0 0 0 0 0 0 0 0 0 0 0 0 0 0 0 0 0 0 0 0 0 0 0 0 0 0 0 0 0 0 0 0 0 0 0 0 0 0 0 0 0 0 0 0 0 0 0 0 0 0 0 
0 0 0 0 0 0 0 0 0 0 0 0 0 0 0 0 0 0 0 0 0 0 0 0 0 0 52 0 0 0 0 0 0 0 0 0 0 0 0 0 0 0 0 52 0 0 0 0 0 0 0 0 0 52 0 0 0 0 0 0 0 52 0 0 0 0 0 0 0 0 
0 52 0 0 0 0 0 0 0 0 52 0 0 0 0 0 0 0 0 0 0 0 0 0 0 0 0 0 0 0 0 0 0 0 0 0 0 0 0 0 0 52 0 0 0 0 0 0 0 0 0 0 0 0 0 0 0 0 0 0 0 0 0 0 0 0 0 0 0 0 
0 0 0 0 0 0 0 0 0 0 0 0 0 0 0 0 0 0 0 0 0 0 0 0 0 0 0 0 0 0 0 0 0 0 0 0 0 0 0 0 0 0 52 52 0 0 0 0 0 0 0 0 0 0 0 0 0 0 0 0 0 0 0 0 0 0 0 0 0 0 
0 0 0 0 0 0 0 0 0 0 0 0 0 0 0 0 0 0 0 0 52 0 0 0 0 0 0 0 0 0 0 0 0 0 0 0 0 0 0 0 0 0 0 0 0 0 0 0 0 0 0 0 0 0 0 0 0 0 0 0 0 0 0 0 0 0 0 0 0 0 
0 0 0 0 52 0 0 0 0 0 0 0 0 0 0 0 0 0 0 0 0 0 0 0 0 0 0 0 0 0 0 0 0 0 0 0 0 0 0 0 0 0 0 0 0 0 0 0 0 0 0 0 0 0 0 0 0 0 0 0 0 0 0 0 52 0 0 0 0 0 
0 0 0 0 0 0 0 0 0 55 55 55 55 55 55 55 55 55 55 55 55 55 55 55 55 55 55 55 55 55 55 55 55 55 55 55 55 55 55 55 55 55 55 55 55 55 55 55 55 55 55 55 55 55 55 55 55 55 55 55 55 0 0 0 0 0 0 0 0 0 
0 0 0 0 0 0 0 0 0 55 0 0 0 0 0 0 0 0 52 0 0 0 0 0 0 0 0 0 0 0 0 0 0 0 0 0 0 0 0 0 0 0 0 0 0 0 0 0 0 0 0 0 0 0 0 0 52 0 0 0 55 0 0 0 0 0 0 0 0 0 
0 0 0 0 0 0 0 0 0 55 0 0 0 0 0 0 0 0 0 0 0 0 0 0 0 0 0 52 0 0 0 0 0 0 0 0 0 0 0 0 0 0 0 52 0 0 0 0 0 0 0 0 0 0 0 0 0 0 0 0 55 0 0 0 0 0 0 0 0 0 
0 0 0 0 0 0 0 0 0 55 0 52 0 0 0 0 0 0 0 0 0 0 0 0 0 0 0 0 0 0 0 0 0 0 0 0 0 0 0 0 0 0 0 0 0 0 0 0 0 0 0 0 0 0 0 0 0 0 0 0 55 0 0 0 0 0 0 0 0 0 
0 0 0 0 0 0 0 0 0 55 0 0 0 0 56 56 56 56 56 56 56 56 56 56 56 56 0 0 0 0 0 0 0 0 0 0 55 55 55 55 55 55 55 55 55 55 55 55 55 55 55 55 55 55 0 0 0 0 0 0 55 0 0 0 52 0 52 0 0 0 
0 0 0 0 0 0 0 0 0 55 0 0 0 0 56 2 2 2 2 2 2 2 2 2 58 56 56 0 0 0 0 0 52 0 0 0 55 2 2 2 58 2 2 2 2 2 2 55 2 2 58 2 2 55 0 0 0 0 0 0 55 0 0 0 0 0 0 0 0 0 
0 52 52 0 0 0 0 0 0 55 0 0 0 0 56 2 2 2 2 2 2 2 2 2 58 2 56 56 0 0 0 0 0 0 0 0 55 2 2 58 58 2 2 2 2 2 2 55 2 2 58 2 2 55 0 0 52 0 0 0 55 0 0 0 0 0 0 0 0 0 
0 0 0 0 0 0 0 0 0 55 0 0 0 0 56 2 2 2 2 2 2 2 2 2 58 2 2 56 56 0 0 0 0 0 0 0 55 2 2 58 2 2 2 2 2 2 2 55 2 2 58 2 2 55 0 0 52 0 0 52 55 0 0 0 0 0 52 0 0 0 
0 0 0 0 0 0 0 0 0 55 0 0 0 0 56 2 2 2 2 2 2 2 2 2 58 58 2 2 56 56 0 0 0 0 0 0 55 2 2 58 58 2 2 2 2 2 2 55 2 2 58 58 2 55 0 0 0 0 0 0 55 0 0 0 0 0 0 0 0 0 
0 0 0 0 0 0 0 0 0 55 0 0 52 0 56 2 2 2 2 2 2 2 2 2 2 58 2 2 2 56 56 0 0 0 0 0 55 55 55 55 55 55 55 55 55 2 2 55 2 2 2 58 2 55 0 0 0 0 0 0 55 0 0 0 0 0 0 0 0 0 
0 0 0 0 52 0 0 0 0 55 0 0 0 0 56 2 2 2 2 2 2 2 2 2 58 58 2 2 2 2 56 0 0 0 0 0 55 2 2 2 2 2 2 2 2 2 2 2 2 2 58 58 2 55 0 0 0 0 0 0 55 0 0 0 0 0 0 0 0 0 
0 0 0 0 0 0 0 0 0 55 0 0 0 0 56 2 2 2 2 2 2 2 2 2 2 58 2 2 2 2 56 0 0 0 0 0 55 2 2 2 2 2 2 2 2 2 2 2 2 2 58 2 2 55 0 0 0 0 0 0 55 0 0 0 0 0 0 0 0 0 
0 0 0 0 0 0 0 0 0 55 0 0 0 0 56 2 2 2 2 2 2 2 2 2 58 58 2 2 2 56 56 0 0 0 0 0 55 2 2 2 2 2 2 2 2 2 2 2 2 2 58 2 2 55 0 0 0 51 0 0 55 0 0 0 0 0 0 0 0 0 
0 0 0 0 0 0 0 0 0 55 0 0 0 0 56 2 2 2 2 2 2 2 2 2 58 2 2 2 56 56 0 0 0 0 0 0 55 2 2 55 55 55 55 55 55 55 55 55 55 55 55 55 55 55 0 52 0 0 0 0 55 0 0 0 0 0 0 0 0 0 
0 0 0 0 0 0 0 0 0 55 0 52 0 0 56 2 2 2 2 2 2 2 2 2 58 2 2 56 56 0 0 0 0 0 0 0 55 2 2 55 2 2 2 2 2 2 2 55 0 0 0 0 0 0 0 0 0 0 51 0 55 0 0 0 0 0 0 0 0 0 
0 0 0 0 0 0 0 0 0 55 0 0 0 0 56 2 2 2 2 2 2 2 2 2 58 2 56 56 0 0 0 0 0 0 0 0 55 2 2 55 2 2 2 2 2 2 2 55 0 0 0 0 0 0 0 0 0 0 0 0 55 0 0 0 0 0 0 0 0 0 
0 0 0 0 0 0 52 0 0 55 0 0 0 0 56 2 2 2 2 2 2 2 2 2 58 56 56 0 0 0 0 0 0 0 0 0 55 2 2 55 2 2 2 2 2 2 2 55 0 0 0 52 0 0 0 0 0 0 0 0 55 0 0 0 0 0 0 0 0 0 
0 0 0 0 0 0 0 0 0 55 0 0 0 0 56 2 2 2 2 2 2 2 2 2 56 56 0 0 0 0 0 0 0 0 0 0 55 2 2 55 2 2 2 2 2 2 2 55 0 0 0 0 0 0 0 0 56 56 56 56 55 0 0 0 0 0 0 0 0 0 
0 0 0 0 0 0 0 0 0 55 0 0 0 0 56 56 56 56 56 56 56 56 57 57 56 0 0 0 0 0 0 0 0 0 0 0 55 57 57 55 55 55 55 55 55 55 55 55 0 0 0 0 0 0 0 56 56 2 2 2 55 0 0 0 0 52 0 0 0 0 
0 0 0 0 0 0 0 0 0 55 0 0 0 0 0 0 0 0 0 0 0 0 2 2 0 0 0 0 0 0 51 51 51 0 0 0 0 2 2 0 0 0 0 0 0 0 0 0 0 0 0 0 0 56 56 56 2 2 2 2 55 0 0 0 0 0 0 0 0 0 
52 52 0 0 0 0 0 0 0 55 0 0 0 0 0 0 0 0 0 0 0 0 2 2 0 0 0 0 0 0 51 0 0 51 51 0 0 2 2 0 0 0 0 0 0 0 0 0 0 0 0 0 56 56 2 2 2 2 2 2 55 0 0 0 0 0 0 0 0 0 
52 52 52 0 0 0 0 0 0 55 0 0 0 0 0 0 0 0 52 0 0 0 2 2 0 0 0 0 0 0 51 0 51 0 51 0 0 2 2 0 0 0 0 52 52 0 0 52 0 0 0 56 56 2 2 2 2 2 2 2 55 0 0 0 0 0 0 0 0 0 
0 0 0 0 0 0 0 0 0 55 0 0 0 0 0 0 0 0 0 0 0 0 2 2 0 0 0 0 0 0 51 51 0 0 0 0 0 2 2 0 0 0 0 0 0 0 0 0 0 0 56 56 2 2 2 2 2 58 58 58 55 0 0 0 0 0 0 0 0 0 
0 52 0 0 0 0 0 0 0 55 0 0 0 0 0 0 0 0 0 0 0 0 2 2 0 0 0 0 0 0 0 0 0 0 0 0 0 2 2 0 0 0 0 0 0 0 0 0 0 0 56 2 2 2 2 2 2 58 58 2 55 0 0 0 0 0 0 0 0 0 
0 0 52 0 0 0 0 0 0 55 0 0 0 0 0 0 0 0 0 0 0 0 2 2 2 2 2 2 2 2 2 2 2 2 2 2 2 2 2 2 2 2 2 2 2 2 2 2 2 2 57 2 2 2 2 2 2 2 58 2 55 0 0 0 0 0 0 0 0 0 
0 0 0 0 0 0 0 0 0 55 0 0 0 0 0 0 0 0 0 0 0 0 2 2 2 2 2 2 2 2 2 2 2 2 2 2 2 2 2 2 2 2 2 2 2 2 2 2 2 2 57 2 2 2 2 2 2 2 58 2 55 0 0 0 52 52 0 0 0 0 
0 0 52 0 0 52 0 0 0 55 0 0 52 0 0 0 52 0 0 0 0 0 2 2 0 52 52 52 52 52 52 52 52 52 0 2 2 52 52 52 0 0 0 0 0 0 52 52 2 2 56 2 2 2 2 2 2 58 58 2 55 0 0 0 0 0 0 0 0 0 
0 0 0 0 0 52 0 0 0 55 0 0 52 52 52 0 0 0 0 0 0 0 2 2 52 52 0 0 0 0 0 0 0 0 0 2 2 52 0 0 0 0 0 52 52 0 52 52 2 2 56 56 2 2 2 2 2 58 58 58 55 0 0 0 0 0 0 0 0 0 
0 52 0 0 52 0 0 52 52 55 52 0 0 52 0 52 52 0 0 0 0 0 2 2 52 52 0 0 0 52 52 52 52 52 52 2 2 52 0 52 52 52 0 0 0 0 0 52 2 2 0 56 56 2 2 2 2 2 2 2 55 0 0 0 0 52 52 0 0 0 
0 52 0 0 0 0 52 52 0 55 0 0 0 52 0 0 52 0 0 0 0 0 2 2 0 0 0 0 52 52 2 2 2 2 2 2 2 2 2 2 2 2 0 0 0 0 0 52 2 2 0 0 56 56 2 2 2 2 2 2 55 0 0 0 0 0 0 0 0 0 
0 52 52 52 0 52 0 0 0 55 0 52 0 0 52 0 0 0 0 0 0 0 2 2 0 0 0 0 0 52 2 2 2 2 2 2 2 2 2 2 2 2 52 0 0 0 0 0 2 2 0 0 0 56 56 2 2 2 2 2 55 0 0 0 0 52 0 0 0 0 
0 52 0 52 0 52 0 52 0 55 0 52 0 52 0 0 0 0 0 0 0 0 2 2 0 0 0 0 0 0 2 2 1 1 1 1 1 1 1 1 2 2 52 0 0 0 52 0 2 2 0 0 0 0 56 56 2 2 2 2 55 0 0 0 0 52 0 0 0 0 
0 52 0 0 52 0 0 0 0 55 0 0 0 52 52 0 0 52 52 0 0 0 2 2 0 0 0 0 0 0 2 2 1 9 9 9 9 9 9 1 2 2 52 0 0 0 0 0 2 2 0 0 52 0 0 56 56 56 56 56 55 0 0 0 0 0 0 0 0 0 
0 0 0 0 52 0 52 52 0 55 0 0 0 0 52 0 52 0 0 0 0 0 2 2 0 0 0 0 0 0 2 2 1 9 52 0 0 52 9 1 2 2 52 0 0 0 52 52 2 2 0 0 0 0 0 0 0 0 0 0 55 0 0 0 0 0 0 0 0 0 
0 52 0 0 0 0 0 0 0 55 0 0 0 0 52 0 52 0 0 0 0 0 2 2 0 52 52 52 52 0 2 2 1 9 9 9 9 9 9 1 2 2 52 0 0 0 52 52 2 2 0 0 52 0 0 0 0 0 0 0 55 0 0 0 0 0 52 0 0 0 
0 52 0 0 0 0 52 0 0 55 0 52 0 52 0 0 52 0 52 0 0 0 2 2 0 0 0 0 52 0 2 2 1 1 1 1 1 1 1 1 2 2 52 0 0 0 0 0 2 2 0 0 0 0 0 0 0 0 0 0 55 0 0 0 0 0 52 0 0 0 
0 0 0 0 0 52 52 0 0 55 0 52 52 0 0 52 0 0 52 0 0 0 2 2 2 2 2 2 2 2 2 2 2 2 2 2 2 2 2 2 2 2 2 2 2 2 2 2 2 2 0 0 0 0 52 0 0 0 0 0 55 0 0 0 0 0 52 0 0 0 
0 52 0 0 0 0 52 0 0 55 0 0 0 52 52 0 0 52 0 0 0 51 2 2 2 2 2 2 2 2 2 2 2 2 2 2 2 2 2 2 2 2 2 2 2 2 2 2 2 2 0 0 0 0 0 52 52 0 0 0 55 0 0 0 0 0 0 0 0 0 
52 0 0 0 0 52 0 0 0 55 0 0 0 52 0 0 0 0 0 0 0 0 2 2 0 0 0 0 0 0 0 0 0 0 0 2 2 0 0 0 0 0 0 0 0 0 0 0 2 2 0 0 0 0 0 0 0 0 0 0 55 0 0 0 0 52 52 0 0 0 
52 0 0 0 52 52 0 0 0 55 0 0 0 0 0 0 0 0 0 0 0 0 2 2 0 0 0 0 0 0 0 0 0 0 0 2 2 0 0 0 0 0 0 0 0 0 0 0 2 2 0 0 0 0 0 0 0 0 0 0 55 0 0 0 0 0 0 0 0 0 
52 0 52 52 0 0 0 0 0 55 0 0 0 0 0 0 0 0 0 0 0 0 2 2 0 0 0 0 0 0 0 0 52 0 0 2 2 52 0 0 0 55 55 55 55 55 55 55 57 57 55 55 55 55 55 55 55 55 0 0 55 0 0 0 0 0 0 0 0 0 
0 0 0 0 0 0 0 0 0 55 0 0 0 0 52 0 52 0 0 0 0 0 2 2 0 0 0 0 0 0 0 0 52 0 0 2 2 0 0 0 0 55 2 2 2 2 2 2 2 2 2 2 2 58 2 2 2 55 0 0 55 0 0 0 0 0 0 0 0 0 
0 0 0 0 0 0 0 0 0 55 0 0 0 0 0 0 0 0 0 0 0 0 2 2 0 0 0 0 52 0 0 0 0 0 0 2 2 0 0 0 0 55 2 2 2 2 2 2 2 2 2 2 2 58 2 2 2 55 0 0 55 0 0 0 0 0 0 0 0 0 
0 0 0 0 0 0 0 0 0 55 0 0 0 0 0 0 0 0 0 0 0 0 2 2 0 0 0 0 0 0 0 0 0 0 0 2 2 0 0 0 0 55 2 2 2 2 2 2 2 2 2 2 2 58 58 58 58 55 0 0 55 0 0 0 0 0 0 0 0 0 
0 0 0 0 0 0 0 0 0 55 0 0 0 0 0 0 0 0 0 0 0 0 2 2 0 0 0 0 0 0 0 0 52 0 0 2 2 52 0 0 0 55 2 2 2 2 2 2 2 2 2 2 2 2 2 2 2 55 0 0 55 0 0 0 0 0 0 0 0 0 
0 0 0 0 0 0 0 0 0 55 0 0 0 0 0 0 0 0 0 0 0 0 2 2 0 0 0 0 0 0 0 0 0 0 0 2 2 0 0 0 0 55 2 2 2 2 2 2 2 2 2 2 2 2 2 2 2 55 0 0 55 0 0 0 0 0 0 0 0 0 
0 0 0 0 0 0 0 0 0 55 0 0 0 0 0 52 0 0 56 56 56 56 57 57 56 56 56 56 56 0 0 0 0 0 0 2 2 0 0 0 0 55 58 58 58 58 2 2 2 2 2 2 2 2 2 2 2 55 0 0 55 0 0 0 0 0 0 0 0 0 
0 0 0 0 0 0 0 0 0 55 0 0 0 0 0 0 0 0 56 2 2 2 2 2 2 2 2 2 56 0 0 0 0 0 0 2 2 0 0 0 0 55 2 2 2 58 2 2 2 2 2 2 2 2 2 2 2 55 0 0 55 0 0 0 0 52 0 0 0 0 
0 0 0 0 0 0 0 0 0 55 0 0 0 0 0 0 0 0 56 2 2 2 2 2 2 2 2 2 56 0 0 0 0 0 0 2 2 0 0 0 0 55 2 2 2 58 2 2 2 2 2 2 2 2 2 2 2 55 0 0 55 0 0 0 0 0 0 0 0 0 
0 0 0 52 0 0 0 0 0 55 0 0 0 0 56 56 56 56 56 2 2 2 2 2 2 2 2 2 56 0 0 0 0 0 0 2 2 0 0 52 0 55 2 2 2 58 2 2 2 2 2 2 2 2 2 2 2 55 0 0 55 0 0 0 0 0 0 0 0 0 
0 0 0 0 0 0 0 0 0 55 0 0 0 0 56 2 2 58 58 2 2 2 2 2 2 2 2 2 56 0 0 0 0 0 0 2 2 0 0 0 0 55 55 55 55 55 55 55 55 55 55 55 55 55 55 55 55 55 0 0 55 0 0 0 0 0 0 0 0 0 
0 0 0 0 0 0 0 0 0 55 0 0 0 0 56 2 2 58 2 2 2 2 2 2 2 2 2 2 56 0 0 0 0 0 0 2 2 0 0 0 0 0 0 0 0 0 0 0 0 0 0 0 51 51 0 0 0 51 0 0 55 0 0 0 52 0 0 0 0 0 
0 0 0 0 0 0 0 0 0 55 0 0 0 0 56 2 2 58 58 2 2 2 2 2 2 2 2 2 56 0 0 0 0 0 0 2 2 0 0 0 0 0 0 0 0 0 0 0 0 0 0 0 0 0 51 0 0 0 0 0 55 0 0 0 0 0 0 0 0 0 
0 0 0 0 0 0 0 0 0 55 0 0 0 0 56 56 56 56 56 56 56 56 56 56 56 56 44 2 56 0 0 0 52 0 0 2 2 0 0 0 0 0 0 0 0 0 0 0 0 0 0 0 0 0 0 0 0 0 0 0 55 0 0 0 0 0 0 0 0 0 
0 0 0 0 0 0 0 0 0 55 0 0 0 0 0 0 0 0 0 0 0 0 0 0 0 56 56 56 56 0 0 0 0 0 0 2 2 0 0 0 0 0 0 0 0 0 52 0 0 0 0 51 0 0 51 0 0 0 0 0 55 0 0 0 0 0 0 0 0 0 
0 0 0 0 0 0 0 0 0 55 0 0 0 0 0 0 0 0 0 0 0 0 0 0 0 0 0 0 0 0 0 0 0 0 0 2 2 0 0 0 0 0 0 0 0 0 0 0 0 0 0 0 0 0 0 0 0 0 0 0 55 0 0 0 0 52 0 0 0 0 
0 0 0 0 0 0 0 0 0 55 0 0 0 0 0 0 0 0 0 0 0 0 0 0 0 0 0 0 0 0 0 0 0 0 0 2 2 0 0 52 0 0 0 0 0 0 0 0 0 0 0 0 0 0 0 0 0 51 0 0 55 0 0 0 0 0 0 0 0 0 
0 0 0 0 0 0 0 0 0 55 0 0 0 52 0 0 0 0 0 0 0 0 0 0 0 0 0 0 0 0 0 0 0 0 0 2 2 0 0 0 0 0 0 0 0 0 0 0 0 0 51 0 0 0 0 0 0 0 0 0 55 0 0 0 0 0 0 0 0 0 
0 0 0 0 0 52 0 0 0 55 0 0 0 0 0 0 0 0 0 0 0 0 0 0 52 0 0 0 0 0 0 0 0 0 0 2 2 0 0 0 0 0 0 0 0 0 51 0 0 0 0 0 0 0 0 0 0 0 0 0 55 0 0 0 0 0 0 0 0 0 
0 0 0 0 0 0 0 0 0 55 0 0 0 0 0 0 0 52 0 0 0 0 0 0 0 0 0 0 0 0 0 0 52 0 0 2 2 0 0 0 0 0 0 0 0 0 0 0 0 0 0 0 51 0 0 0 0 51 0 0 55 0 0 0 0 0 0 0 0 0 
0 0 0 0 0 0 0 0 0 55 0 0 0 0 0 0 0 0 0 0 0 0 0 0 0 0 0 0 0 0 0 0 0 0 55 2 2 55 0 0 0 0 0 0 0 0 0 0 0 0 0 0 0 0 0 0 0 0 0 0 55 0 0 0 0 0 0 0 0 0 
0 0 0 0 0 0 0 0 0 55 55 55 55 55 55 55 55 55 55 55 55 55 55 55 55 55 55 55 55 55 55 55 55 55 55 2 2 55 55 55 55 55 55 55 55 55 55 55 55 55 55 55 55 55 55 55 55 55 55 55 55 0 0 0 0 0 0 0 0 0 
0 0 0 0 0 0 0 0 0 0 0 0 0 0 0 0 0 0 0 0 0 0 0 0 0 0 0 0 0 0 0 0 0 0 0 2 2 0 0 0 0 0 0 0 0 0 0 0 0 0 0 0 0 0 0 0 0 0 0 0 0 0 0 0 0 0 0 0 0 0 
0 0 0 52 0 0 0 0 0 0 0 0 0 0 0 0 0 0 0 0 0 0 0 0 0 0 0 0 0 0 0 0 0 0 0 2 2 0 0 0 0 0 0 0 0 0 0 0 0 0 0 0 0 0 0 0 0 0 0 0 0 0 0 0 52 0 0 0 0 0 
0 0 0 0 0 0 0 0 0 0 0 0 0 0 0 52 0 0 0 0 0 0 0 0 0 0 0 0 0 0 0 0 0 0 0 2 2 0 0 0 0 0 0 0 0 0 0 0 0 0 0 0 51 0 0 0 0 0 0 0 0 0 51 0 52 0 0 0 0 0 
0 0 0 0 0 0 0 0 0 0 0 0 0 0 0 0 0 0 0 0 0 0 0 0 0 0 0 52 0 0 0 0 2 2 2 2 2 0 0 0 0 0 0 0 0 52 0 0 0 0 0 0 0 0 0 0 0 0 0 51 0 0 0 0 0 51 0 0 0 0 
0 0 0 0 0 0 0 0 0 0 0 0 0 0 0 0 0 0 0 52 0 0 0 0 0 0 0 0 0 0 0 0 2 2 2 2 2 0 0 0 0 52 0 0 0 0 0 52 52 0 0 0 0 0 0 0 0 0 0 0 0 0 0 0 0 0 0 0 0 0 
0 0 0 0 0 0 0 0 0 0 0 0 0 0 0 0 0 0 0 0 0 0 0 0 0 0 0 0 0 0 0 0 2 2 51 51 51 51 51 0 51 0 0 0 0 0 0 0 0 0 0 0 0 0 0 0 51 0 0 0 0 0 0 0 0 0 0 0 0 0 
0 0 0 0 0 0 0 0 52 0 0 0 0 0 0 0 0 0 0 0 0 0 0 0 0 0 0 0 0 0 0 52 2 2 0 0 0 0 0 0 0 51 0 0 0 0 0 0 52 0 0 0 0 0 0 0 0 0 0 0 0 0 0 0 0 0 0 0 0 0 
0 0 0 0 0 0 0 0 0 0 0 0 0 0 0 0 0 0 0 0 0 0 0 0 0 0 0 0 0 0 0 0 2 2 0 0 0 0 0 0 0 51 0 0 0 0 0 0 0 0 0 0 0 0 0 0 0 0 0 0 0 0 0 0 0 0 0 0 0 0 
0 0 0 0 0 0 0 0 0 0 0 0 0 0 0 0 0 0 0 0 0 0 0 0 0 0 0 0 0 0 0 0 2 2 0 0 0 0 0 0 0 0 0 0 0 0 0 0 0 0 0 0 0 0 0 0 0 0 0 0 0 0 0 0 0 0 0 0 0 0 
0 0 0 0 0 0 0 0 0 0 0 0 0 0 0 0 0 0 0 0 0 0 0 0 0 0 0 0 0 0 0 0 2 2 0 0 0 0 0 0 0 0 0 0 0 0 0 0 0 0 0 0 0 0 0 0 0 0 0 0 0 0 0 0 0 0 0 0 0 0 
