20 20
55 55 55 55 55 55 55 55 55 55 55 55 55 55 55 55 55 55 55 55 
55 2 2 2 2 2 2 2 2 2 2 2 2 2 2 2 2 2 2 55 
55 2 2 2 2 2 2 2 2 2 2 2 2 2 2 2 2 2 2 55 
55 2 2 2 2 2 2 2 2 2 2 2 2 2 2 2 2 2 2 55 
55 2 2 2 2 2 2 2 2 2 2 2 2 2 2 2 2 2 2 55 
55 2 2 2 2 2 2 2 2 2 2 2 2 2 2 2 2 2 2 55 
55 2 2 2 2 2 2 2 2 2 2 2 2 2 2 2 2 2 2 55 
55 2 2 2 2 2 2 2 2 2 2 2 2 2 2 2 2 2 2 55 
55 2 2 2 2 2 2 2 2 2 2 2 2 2 2 2 2 2 2 55 
55 2 2 2 2 2 2 2 2 2 2 2 2 2 2 2 2 2 2 55 
55 2 2 2 2 2 2 2 2 2 2 2 2 2 2 2 2 2 2 55 
55 2 2 2 2 2 2 2 2 2 2 2 2 2 2 2 2 2 2 55 
55 2 2 2 2 2 2 2 2 2 2 2 2 2 2 2 2 2 2 55 
55 2 2 2 2 2 2 2 2 2 2 2 2 2 2 2 2 2 2 55 
55 2 2 2 2 2 2 2 2 2 2 2 2 2 2 2 2 2 2 55 
55 2 2 2 2 2 2 2 2 2 2 2 2 2 2 2 2 2 2 55 
55 2 2 2 2 2 2 2 2 2 2 2 2 2 2 2 2 2 2 55 
55 2 2 2 2 2 2 2 2 2 2 2 2 2 2 2 2 2 2 55 
55 2 2 2 2 2 2 2 55 2 45 2 55 2 2 2 2 2 2 55 
55 55 55 55 55 55 55 55 55 55 55 55 55 55 55 55 55 55 55 55 
