70 80
54 54 54 54 54 54 54 54 54 54 54 54 54 54 54 54 54 54 54 54 54 54 54 54 54 54 54 54 54 54 54 54 54 54 54 54 54 54 54 54 54 54 54 54 54 54 54 54 54 54 54 54 54 54 54 54 54 54 54 54 54 54 54 54 54 54 54 54 54 54 
54 54 54 54 54 54 54 54 54 54 54 54 54 54 54 54 54 54 54 54 54 54 54 54 54 54 54 54 54 54 54 54 54 54 54 54 54 54 54 54 54 54 54 54 54 54 54 54 54 54 54 54 54 54 54 54 54 54 54 54 54 54 54 54 54 54 54 54 54 54 
54 54 54 54 54 54 54 54 54 54 54 54 54 54 54 54 54 54 54 54 54 54 54 54 54 54 54 54 54 54 54 54 54 54 54 54 54 54 54 54 54 54 54 0 0 54 54 54 54 54 54 54 54 54 54 54 54 54 54 54 54 54 54 54 54 54 54 54 54 54 
54 54 54 54 54 54 54 54 54 54 54 54 54 54 52 52 52 54 54 54 54 54 54 54 54 54 54 54 54 54 54 54 54 54 54 54 54 54 52 52 52 52 52 52 52 0 0 0 0 0 0 54 54 54 54 54 54 54 54 54 54 54 54 54 54 54 54 54 54 54 
54 54 54 54 54 54 54 54 54 54 0 0 52 52 0 0 0 52 52 54 54 54 54 54 54 54 54 54 54 54 54 54 54 54 54 0 0 52 52 0 0 0 0 0 0 52 52 0 0 0 0 54 54 54 54 54 54 54 54 54 54 54 54 54 54 54 54 54 54 54 
54 54 54 54 54 54 54 0 0 0 52 52 0 0 0 0 0 0 52 52 0 0 0 0 0 0 0 0 0 0 0 52 0 0 52 52 52 52 0 0 0 0 0 0 0 0 0 0 52 52 52 0 0 0 0 0 0 0 0 0 0 54 54 54 54 54 54 54 54 54 
54 54 54 54 54 0 0 0 0 52 0 0 0 0 0 0 0 0 0 0 52 52 0 52 52 52 52 52 0 52 52 0 0 0 0 0 0 0 0 0 0 0 0 0 0 0 0 0 0 0 0 52 52 0 52 52 0 0 0 0 0 0 54 54 54 54 54 54 54 54 
54 54 54 54 0 0 0 0 52 52 0 0 0 0 0 0 0 0 0 0 0 0 0 0 0 0 0 0 0 0 0 0 0 0 0 0 0 0 0 0 0 0 0 0 0 0 0 0 0 0 0 0 0 0 0 0 0 0 0 0 0 0 54 54 54 54 54 54 54 54 
0 0 0 0 0 0 0 52 0 55 55 55 55 55 55 55 55 55 55 55 55 55 55 55 55 55 55 55 55 55 55 55 55 55 55 55 55 55 55 55 55 55 55 55 55 55 55 55 55 55 55 55 55 55 55 55 55 55 55 55 55 0 54 54 54 54 54 54 54 54 
0 0 0 0 0 0 52 52 0 55 0 0 0 0 0 0 0 0 0 0 0 0 0 0 0 0 0 0 0 0 0 0 0 0 0 0 51 0 0 0 0 0 0 0 0 0 0 0 0 0 0 0 0 0 0 0 0 0 0 0 55 0 54 54 54 54 54 54 54 54 
0 0 0 0 0 0 52 0 0 55 0 0 0 56 56 56 56 56 56 56 56 56 56 56 56 56 56 56 56 56 56 56 56 56 56 56 56 56 56 56 56 56 56 56 56 56 56 56 56 56 56 56 56 56 56 56 56 51 0 0 55 0 54 54 54 54 54 54 54 54 
0 0 0 0 0 52 0 0 0 55 0 51 0 56 2 2 2 2 56 2 2 2 2 56 2 2 2 2 2 2 2 2 2 2 2 2 2 56 2 2 2 2 2 56 2 2 2 2 2 58 2 2 2 2 2 2 56 0 0 51 55 0 54 54 54 54 54 54 54 54 
0 0 0 0 0 0 0 0 0 55 0 0 0 56 2 2 2 2 56 2 2 2 2 56 2 2 2 58 58 58 58 58 58 58 58 58 58 56 2 2 2 2 2 57 2 2 2 2 2 58 2 2 2 2 2 2 56 0 0 0 55 54 54 54 54 54 54 54 54 54 
0 0 0 0 0 0 0 0 0 55 0 0 0 56 2 2 2 2 56 2 2 2 2 57 2 2 2 58 2 2 2 2 2 2 2 2 2 56 2 2 2 2 2 56 58 58 58 58 58 58 2 2 2 2 2 2 56 0 0 54 54 54 54 54 54 54 54 54 54 54 
0 0 0 0 0 0 0 0 0 55 0 51 0 56 2 2 2 2 56 2 2 2 2 56 2 2 2 58 2 2 2 2 2 2 2 2 2 56 2 2 2 2 2 56 2 2 2 2 2 2 2 2 2 2 2 2 56 0 0 54 54 54 54 54 54 54 54 54 54 54 
0 0 0 0 0 0 0 0 0 55 0 51 0 56 2 2 2 2 56 2 2 2 2 56 56 56 56 56 56 56 56 56 56 56 56 2 2 56 56 56 56 56 56 56 56 56 56 56 56 56 56 56 2 2 56 56 56 0 54 54 54 54 54 54 54 54 54 54 54 54 
0 52 0 0 0 0 0 0 0 55 0 0 0 56 2 2 2 2 56 2 2 2 2 56 56 56 56 56 56 56 56 56 56 56 56 2 2 2 2 2 2 2 2 2 2 2 2 2 2 2 2 2 2 2 2 2 56 0 54 54 54 54 54 54 54 54 54 54 54 54 
52 0 0 0 0 0 0 0 0 55 0 0 0 56 2 2 2 2 56 2 2 2 2 56 56 56 56 56 56 56 56 56 56 56 56 2 2 2 2 2 2 2 2 2 2 2 2 2 2 2 2 2 2 2 2 2 56 0 54 54 54 54 54 54 54 54 54 54 54 54 
0 0 0 0 0 0 0 0 0 55 0 51 0 56 56 57 56 56 56 56 56 56 56 56 56 56 56 56 56 56 56 56 56 56 56 57 57 56 56 56 56 56 56 56 56 56 56 56 56 56 56 56 57 57 56 56 56 0 54 54 54 54 54 54 54 54 54 54 54 54 
0 0 0 0 0 0 0 0 0 55 51 0 0 56 2 2 2 58 2 2 2 2 2 56 0 0 0 0 0 0 0 0 0 0 0 2 2 0 0 0 0 0 0 0 0 0 0 0 0 0 0 0 2 2 0 0 0 0 0 54 54 54 54 54 54 54 54 54 54 54 
0 0 0 0 0 0 0 0 0 55 51 0 0 56 2 2 2 58 2 2 2 2 2 56 0 0 0 0 0 0 0 0 0 0 0 2 2 0 0 0 0 0 0 0 0 0 0 0 0 0 0 0 2 2 0 0 0 0 0 0 54 54 54 54 54 54 54 54 54 54 
0 0 0 0 0 0 0 0 0 55 51 0 0 56 2 2 2 58 2 2 2 2 2 56 0 0 0 0 0 0 0 0 0 0 0 2 2 0 0 0 0 52 0 0 0 52 0 0 0 0 0 0 2 2 0 0 0 51 0 0 55 0 54 54 54 54 54 54 54 54 
0 0 0 0 0 0 0 0 0 55 51 51 0 56 2 2 2 58 2 2 2 2 2 57 2 2 2 2 2 2 2 2 2 2 2 2 2 0 0 0 0 0 0 0 0 0 0 0 0 0 0 0 2 2 0 0 0 51 0 0 55 0 0 54 54 54 54 54 54 54 
0 0 0 0 0 0 0 0 0 55 0 51 0 56 2 2 2 58 2 2 2 2 2 57 2 2 2 2 2 2 2 2 2 2 2 2 2 0 0 0 0 0 0 0 0 0 0 0 0 0 0 0 2 2 0 0 0 0 0 0 55 0 0 54 54 54 54 54 54 54 
0 0 0 0 0 0 0 0 0 55 0 0 0 56 2 2 2 58 2 2 2 2 2 56 0 0 0 0 0 0 0 0 0 0 0 2 2 0 0 0 0 0 0 0 0 52 0 0 0 0 0 0 2 2 0 0 0 0 0 0 55 0 0 54 54 54 54 54 54 54 
0 0 0 52 0 0 0 0 0 55 0 0 0 56 2 2 2 58 2 2 2 2 2 56 0 0 0 0 0 0 0 0 0 0 0 2 2 0 0 0 0 52 0 0 0 0 0 0 0 0 0 0 2 2 0 0 0 0 0 0 55 52 0 54 54 54 54 54 54 54 
0 0 0 52 0 0 0 0 0 55 0 0 0 56 2 2 2 58 2 2 2 2 2 56 0 0 0 0 0 0 0 0 0 0 0 2 2 0 0 0 0 0 0 0 0 0 0 0 56 56 56 56 57 57 56 56 56 0 0 0 55 52 0 54 54 54 54 54 54 54 
0 0 0 0 0 0 0 0 0 55 0 0 0 56 56 56 56 56 56 56 56 56 56 56 0 0 0 0 0 0 0 0 0 0 0 2 2 0 0 0 0 0 0 0 0 0 0 0 56 2 2 2 2 2 2 2 56 0 0 0 55 0 0 0 54 54 54 54 54 54 
0 0 0 52 0 0 0 0 0 55 0 0 0 0 0 0 0 0 0 0 0 0 0 0 0 0 0 0 0 0 0 0 0 0 0 2 2 0 0 0 0 0 0 0 0 0 0 0 56 2 2 2 2 2 2 2 56 0 0 0 55 52 0 0 54 54 54 54 54 54 
0 0 0 52 52 52 0 0 0 55 0 0 0 0 0 0 0 0 0 0 0 0 0 0 0 0 0 0 51 0 0 0 0 0 0 2 2 0 0 0 0 0 0 0 0 0 0 0 56 2 2 2 2 2 2 2 56 0 0 0 55 0 0 0 54 54 54 54 54 54 
0 0 0 0 0 0 0 0 0 55 0 0 0 0 0 0 0 0 0 0 0 0 0 0 0 0 0 0 0 0 0 0 0 0 0 2 2 2 2 2 2 2 2 2 2 2 2 2 57 2 2 2 58 58 58 58 56 0 0 0 55 52 0 0 54 54 54 54 54 54 
0 0 0 0 0 0 0 0 0 55 0 0 0 0 0 0 0 0 0 51 0 0 0 0 0 0 0 0 0 0 0 0 0 0 0 2 2 2 2 2 2 2 2 2 2 2 2 2 57 2 2 2 58 2 2 2 56 0 0 0 55 0 0 0 54 54 54 54 54 54 
0 0 0 0 0 0 0 0 0 55 0 0 0 0 0 0 0 0 0 0 0 0 0 0 52 0 0 0 0 0 0 52 0 0 0 2 2 0 0 0 0 0 0 0 0 0 0 0 56 2 2 2 58 2 2 2 56 0 0 0 55 52 0 0 54 54 54 54 54 54 
0 0 0 0 0 0 0 0 0 55 0 0 0 0 0 0 0 0 0 0 0 0 0 0 52 0 0 0 0 0 0 0 0 0 0 2 2 0 0 0 0 0 0 0 0 0 0 0 56 2 2 2 58 2 2 2 56 0 0 0 55 0 0 0 54 54 54 54 54 54 
0 0 0 0 0 0 0 0 0 55 0 0 0 51 0 52 52 0 0 0 0 0 0 52 52 0 0 0 0 0 0 0 0 0 0 2 2 0 0 0 0 0 0 0 0 0 0 0 56 2 2 2 58 2 2 2 56 0 0 0 55 0 0 54 54 54 54 54 54 54 
0 0 0 0 0 0 0 0 0 55 0 0 0 0 0 0 0 0 0 0 0 0 52 0 0 52 0 0 0 0 0 0 0 0 0 2 2 0 0 0 0 0 0 0 0 0 0 0 56 2 2 2 58 2 2 2 56 56 56 0 55 52 0 54 54 54 54 54 54 54 
0 0 0 0 0 0 0 0 0 55 0 0 0 0 0 0 0 0 0 0 51 52 0 0 0 0 0 0 0 0 0 0 0 0 0 2 2 0 0 0 0 0 0 0 0 0 0 0 56 2 2 2 58 2 2 2 57 2 56 0 55 52 0 54 54 54 54 54 54 54 
0 0 0 0 0 0 0 0 0 55 0 0 0 0 0 0 0 0 0 0 52 0 0 0 0 0 0 0 0 0 0 0 0 0 0 2 2 0 0 0 0 0 0 0 0 0 0 0 56 2 2 2 58 2 2 2 56 2 56 0 55 52 0 54 54 54 54 54 54 54 
0 0 0 0 0 0 0 0 0 55 0 0 0 0 0 0 0 0 0 0 0 0 0 0 0 0 0 0 0 0 0 0 0 0 0 2 2 0 0 0 0 0 0 0 0 0 0 0 56 56 56 56 56 56 57 56 56 2 56 0 55 0 52 54 54 54 54 54 54 54 
0 0 0 0 0 0 0 0 0 55 0 0 0 0 0 52 0 0 0 0 0 0 0 0 0 0 0 0 0 0 0 0 0 0 0 2 2 0 0 0 0 0 0 0 0 0 0 0 0 0 0 0 0 56 2 2 2 2 56 0 55 0 52 54 54 54 54 54 54 54 
0 52 0 0 0 0 0 0 0 55 0 0 0 0 52 52 0 0 0 0 0 0 0 0 0 0 0 0 0 0 0 0 0 0 0 2 2 0 0 0 0 52 0 0 0 0 0 0 0 52 52 0 52 56 2 2 2 2 56 0 55 0 52 54 54 54 54 54 54 54 
0 0 0 0 0 0 0 0 0 55 0 0 0 0 52 52 52 0 0 56 56 56 56 56 56 56 56 56 56 56 0 0 0 0 0 2 2 0 0 0 0 0 0 0 0 52 0 0 0 52 0 0 0 56 56 56 56 56 56 0 55 0 0 54 54 54 54 54 54 54 
0 0 52 0 0 0 0 0 0 55 0 0 0 0 52 0 0 0 0 56 2 2 2 56 2 2 2 2 2 56 0 0 0 0 0 2 2 0 0 0 0 0 0 0 0 52 0 0 0 0 0 0 0 0 0 0 0 52 0 0 55 0 0 54 54 54 54 54 54 54 
0 0 52 52 52 0 0 0 0 55 0 0 0 0 52 0 0 0 0 56 2 2 2 56 2 2 2 2 2 56 0 0 0 0 0 2 2 0 0 0 0 0 0 0 0 0 0 0 9 9 9 9 9 0 0 0 52 52 52 0 55 0 0 54 54 54 54 54 54 54 
0 0 0 0 0 0 0 0 0 55 0 0 0 52 0 0 0 0 0 56 2 2 2 56 2 2 2 2 2 56 0 0 0 0 0 2 2 0 0 0 0 0 0 0 0 0 0 9 9 9 9 9 9 9 0 0 0 52 52 0 55 0 0 54 54 54 54 54 54 54 
0 0 0 0 0 0 0 0 0 55 0 0 0 52 0 0 0 0 0 56 2 2 2 56 58 58 58 58 58 56 0 0 0 0 0 2 2 0 0 0 0 0 0 52 0 0 9 9 9 9 9 9 9 9 9 9 0 52 52 0 55 0 0 54 54 54 54 54 54 54 
0 0 0 0 0 0 0 0 0 55 0 0 0 0 0 0 51 0 0 56 2 2 2 57 2 2 2 2 58 56 0 0 0 0 0 2 2 0 0 0 0 0 0 52 0 0 9 9 9 9 9 9 0 0 9 9 0 52 52 0 55 0 0 54 54 54 54 54 54 54 
0 0 0 0 0 0 0 0 0 55 0 0 52 0 0 0 0 0 0 56 56 56 56 56 2 2 2 2 2 57 2 2 2 2 2 2 2 0 0 0 0 0 0 0 0 0 9 9 9 9 9 0 0 0 9 9 0 52 52 0 55 0 0 54 54 54 54 54 54 54 
0 0 0 0 0 0 52 0 0 55 0 0 0 0 0 0 0 0 0 56 2 2 2 57 2 2 2 2 2 57 2 2 2 2 2 2 2 0 0 0 0 0 52 0 0 0 9 9 9 9 0 0 0 9 9 9 0 52 52 0 55 0 0 0 54 54 54 54 54 54 
0 0 0 0 0 0 52 0 0 55 0 0 0 0 0 0 0 0 0 56 2 2 2 56 2 2 56 56 56 56 0 0 0 0 0 2 2 0 0 0 0 0 52 0 0 0 9 9 9 9 9 9 9 9 9 9 0 52 0 0 55 0 0 0 54 54 54 54 54 54 
0 0 0 0 0 0 52 0 0 55 0 0 0 0 0 0 0 0 0 56 2 2 2 56 2 2 56 2 2 56 0 0 0 0 0 2 2 0 0 0 0 0 0 0 0 0 9 9 9 9 9 9 9 9 9 9 0 52 0 0 55 0 0 0 0 54 54 54 54 54 
0 0 0 0 0 0 52 0 0 55 0 0 0 0 0 0 0 0 0 56 2 2 2 56 2 2 57 2 2 56 0 0 0 0 0 2 2 0 0 0 0 0 52 0 0 0 9 9 9 9 9 9 9 9 9 9 0 52 0 0 55 0 0 0 0 0 54 54 54 54 
0 0 0 0 0 0 52 0 0 55 0 0 0 51 0 0 0 0 0 56 2 2 2 56 2 2 56 2 2 56 0 0 0 0 0 2 2 0 0 0 0 0 52 0 0 0 9 9 9 9 9 9 9 9 9 0 0 52 0 0 55 0 0 52 0 0 0 0 54 54 
0 0 0 0 0 0 0 0 0 55 0 0 0 51 0 0 0 0 0 56 56 56 56 56 2 2 56 2 2 56 0 0 0 0 0 2 2 0 0 0 0 0 0 0 0 9 9 9 9 9 0 9 9 9 9 0 0 52 0 0 55 0 0 52 52 52 52 0 0 0 
0 0 52 0 0 0 0 0 0 55 0 0 0 51 0 0 0 0 0 56 2 2 2 56 2 2 56 56 56 56 0 0 0 0 0 2 2 0 0 0 0 0 0 0 9 9 9 9 9 0 0 9 9 9 9 0 0 52 0 0 55 0 0 0 0 0 52 0 0 0 
0 0 0 0 0 52 0 0 0 55 0 0 0 51 0 0 0 0 0 56 2 2 2 56 2 2 56 2 2 56 0 0 0 0 0 2 2 0 0 0 0 0 0 0 9 9 9 9 9 0 0 9 9 9 9 0 0 52 0 0 55 0 0 0 0 0 52 0 0 0 
0 0 0 0 0 0 0 0 0 55 0 0 0 51 0 0 0 0 0 56 2 2 2 57 2 2 57 2 2 56 0 0 0 0 0 2 2 0 0 0 0 0 0 9 9 9 9 9 0 0 0 9 9 9 9 9 9 52 52 0 55 0 0 0 0 0 52 0 0 0 
0 0 0 0 0 0 0 0 0 55 0 0 0 51 0 0 0 0 0 56 2 2 2 56 2 2 56 2 2 56 0 0 0 0 0 2 2 0 0 0 0 0 0 9 9 9 9 9 9 9 9 9 9 9 9 9 9 9 52 0 55 0 0 0 0 0 52 0 0 0 
0 0 0 0 0 0 0 0 0 55 0 0 0 51 0 0 0 0 0 56 56 56 56 56 2 2 56 56 56 56 0 0 0 0 0 2 2 0 0 0 0 52 0 9 9 9 9 9 9 9 9 9 9 9 9 9 9 9 0 0 55 0 0 0 0 52 0 0 0 0 
0 0 0 0 0 0 0 0 0 55 0 0 0 0 0 0 0 0 0 56 2 2 2 56 2 2 57 2 2 56 0 0 0 0 0 2 2 0 0 0 0 52 0 9 9 9 9 9 9 9 9 9 9 9 9 9 9 9 0 0 55 0 0 0 0 0 0 0 0 0 
0 0 0 0 0 0 0 0 0 55 0 0 0 0 0 0 0 0 0 56 2 2 2 57 2 2 56 2 2 56 0 0 0 0 0 2 2 0 0 0 0 0 0 9 9 9 9 9 9 9 9 9 9 9 9 9 9 9 0 0 55 0 0 0 52 52 0 0 0 0 
0 0 0 0 0 0 0 0 0 55 0 0 0 0 51 0 0 0 0 56 2 2 2 56 2 2 56 2 2 56 0 0 0 0 0 2 2 0 0 0 0 0 0 9 9 9 9 9 9 9 9 9 9 9 9 9 9 9 0 52 55 0 0 52 52 0 0 0 0 0 
0 0 0 0 0 0 0 0 0 55 0 0 0 0 0 0 0 0 0 56 56 56 56 56 56 56 56 56 56 56 0 0 0 0 0 2 2 0 0 0 0 0 0 9 9 9 9 9 9 9 9 9 9 9 9 9 9 9 0 52 55 0 52 52 0 0 0 0 0 0 
0 0 0 0 0 0 0 0 0 55 0 0 0 0 0 0 0 0 0 0 0 0 0 0 0 52 52 0 0 0 0 0 0 0 0 2 2 0 0 0 0 0 0 0 0 0 0 0 0 0 9 9 9 9 9 9 9 0 0 0 55 0 52 52 0 0 0 0 0 0 
0 0 0 0 0 0 0 0 0 55 0 0 0 0 0 0 0 0 0 0 0 0 0 0 0 52 52 52 0 0 0 0 0 0 0 2 2 0 0 0 0 0 0 0 52 52 52 52 52 0 0 9 9 9 9 9 0 0 0 0 55 0 0 0 52 0 0 0 0 0 
0 0 0 0 0 0 0 0 0 55 0 0 52 0 0 0 0 0 0 0 0 0 0 0 0 0 52 52 52 52 52 0 0 0 0 2 2 0 0 0 0 0 52 0 0 0 0 0 0 0 0 0 0 0 0 52 52 52 0 0 55 0 0 0 0 0 0 0 0 0 
0 0 0 0 52 0 0 0 0 55 0 0 0 0 0 0 0 51 0 0 0 0 0 52 52 52 52 52 52 52 0 0 0 0 0 2 2 0 0 0 0 0 52 0 0 0 0 0 0 0 0 0 52 52 52 52 0 0 0 0 55 0 0 0 0 0 0 0 0 0 
0 0 0 0 52 0 0 0 0 55 0 0 0 0 0 0 0 51 0 0 0 0 0 0 0 0 0 0 0 0 0 0 0 0 0 2 2 0 0 0 0 0 52 52 0 0 0 0 0 0 0 0 0 0 0 0 0 0 0 0 55 0 0 0 0 0 0 0 0 0 
0 0 0 52 0 52 0 0 0 55 0 0 0 0 0 0 0 0 0 0 0 0 0 0 0 0 0 0 0 0 0 0 0 0 55 2 2 55 0 0 0 0 0 52 52 52 52 52 0 0 0 0 0 0 0 0 0 0 0 0 55 0 0 0 0 0 0 0 0 0 
0 0 0 0 0 0 0 0 0 55 55 55 55 55 55 55 55 55 55 55 55 55 55 55 55 55 55 55 55 55 55 55 55 55 55 2 2 55 55 55 55 55 55 55 55 55 55 55 55 55 55 55 55 55 55 55 55 55 55 55 55 0 0 0 0 0 0 0 0 0 
0 0 0 0 0 0 0 0 0 0 0 0 0 0 0 0 0 0 0 0 0 0 0 0 0 0 0 0 0 0 0 0 0 0 0 2 2 0 0 0 0 0 0 0 0 0 0 0 0 0 0 0 0 0 0 0 0 0 0 0 0 0 0 0 0 0 0 0 0 0 
0 0 0 0 0 0 0 0 0 0 0 0 0 0 0 0 0 0 0 0 0 0 0 0 0 0 0 0 0 0 0 0 0 0 0 2 2 0 0 0 0 0 0 0 0 0 0 0 0 0 0 0 0 0 0 0 0 0 0 0 0 0 52 0 0 0 0 0 0 0 
0 0 0 0 0 0 0 0 0 0 0 0 0 0 0 0 0 0 0 0 0 0 0 0 0 0 0 0 0 0 0 0 0 0 0 2 2 0 0 0 0 0 0 0 0 0 0 0 0 0 0 0 0 0 0 0 0 0 0 0 52 0 0 0 0 0 0 0 0 0 
2 2 2 2 2 2 2 2 2 2 2 2 2 2 2 2 2 2 2 2 2 2 2 2 2 2 2 2 2 2 2 2 2 2 2 2 2 0 0 0 0 52 52 52 0 0 0 0 0 0 0 0 0 0 0 0 0 0 0 52 0 0 0 0 0 0 0 0 0 0 
2 2 2 2 2 2 2 2 2 2 2 2 2 2 2 2 2 2 2 2 2 2 2 2 2 2 2 2 2 2 2 2 2 2 2 2 2 0 0 0 0 0 52 52 52 0 0 0 0 0 0 0 0 0 0 52 52 52 0 0 0 0 0 0 0 0 0 0 0 0 
0 0 0 0 0 0 0 0 0 0 0 0 0 0 0 0 0 0 0 0 0 0 0 0 0 0 0 0 0 0 0 0 0 0 0 0 0 0 0 0 0 0 52 0 0 52 0 52 52 52 52 52 0 0 0 0 0 0 0 0 0 0 0 0 0 0 0 0 0 0 
0 0 0 0 0 0 0 0 0 0 52 0 0 0 0 0 0 0 0 0 0 0 0 0 0 0 0 0 0 0 0 0 0 0 0 0 0 0 0 0 0 0 0 0 0 0 0 0 0 0 0 0 0 0 0 0 0 0 0 0 0 0 0 0 0 0 0 0 0 0 
0 0 0 0 0 0 0 0 0 0 0 0 0 0 0 0 0 52 52 0 0 0 52 52 0 0 0 0 52 52 52 52 0 0 0 0 0 0 52 52 0 0 0 0 0 0 0 0 0 0 0 0 0 0 0 0 0 0 0 0 0 0 0 0 0 0 0 0 0 0 
0 0 0 0 0 0 0 0 0 0 0 0 0 0 0 0 0 0 0 0 0 0 0 0 0 0 0 0 0 0 0 0 0 0 0 0 0 0 0 0 0 0 0 0 0 0 0 0 0 0 0 0 0 0 0 0 0 0 0 0 0 0 0 0 0 0 0 0 0 0 
0 0 0 0 0 0 0 0 0 0 0 0 0 0 0 0 0 0 0 0 0 0 0 0 0 0 0 0 0 0 0 0 0 0 0 0 0 0 0 0 0 0 0 0 0 0 0 0 0 0 0 0 0 0 0 0 0 0 0 0 0 0 0 0 0 0 0 0 0 0 
