70 80
9 9 9 9 9 9 9 9 9 9 9 9 9 9 9 9 9 9 9 9 9 9 9 9 9 9 9 9 9 9 9 9 9 9 9 9 9 9 9 9 9 9 9 9 9 9 9 9 9 9 9 9 9 9 9 9 9 9 9 9 55 0 0 0 0 0 0 0 0 0 
9 9 9 9 9 9 9 9 9 9 9 9 9 9 9 9 9 9 9 9 9 9 9 9 9 9 9 9 9 9 9 9 9 9 9 9 9 9 9 9 9 9 9 9 9 9 9 9 9 9 9 9 9 9 9 9 9 9 9 9 55 0 0 0 0 0 0 0 0 0 
9 9 9 9 9 9 9 9 9 9 9 9 9 9 9 9 9 9 9 9 9 9 9 9 9 9 9 9 9 9 9 9 9 9 9 9 9 9 9 9 9 9 9 9 9 9 9 9 9 9 9 9 9 9 9 9 9 9 9 9 55 0 0 0 0 0 0 0 0 0 
9 9 9 9 9 9 9 9 9 9 9 9 9 9 9 9 9 9 9 9 9 9 9 9 9 9 9 9 9 9 9 9 9 9 9 9 9 9 9 9 9 9 9 9 9 9 9 9 9 9 9 9 9 9 9 9 9 9 9 9 55 0 0 0 0 0 0 0 0 0 
9 9 9 9 9 9 9 9 9 9 9 9 9 9 9 9 9 9 9 9 9 9 9 9 9 9 9 9 9 9 9 9 9 9 9 9 9 9 9 9 9 9 9 9 9 9 9 9 9 9 9 9 9 9 9 9 9 9 9 9 55 0 0 0 0 0 0 0 0 0 
9 9 9 9 9 9 9 9 9 9 9 9 9 9 9 9 9 9 9 9 9 9 9 9 9 9 9 9 9 9 9 9 9 9 9 9 9 9 9 9 9 9 9 9 9 9 9 9 9 9 9 9 9 9 9 9 9 9 9 9 55 0 0 0 0 0 0 0 0 0 
9 9 9 9 9 9 9 9 9 9 9 9 9 9 9 9 9 9 9 9 9 9 9 9 9 9 9 9 9 9 9 9 9 9 9 9 9 9 9 9 9 9 9 9 9 9 9 9 9 9 9 9 9 9 9 9 9 9 9 9 55 0 0 0 0 0 0 0 0 0 
9 9 9 9 9 9 9 9 9 9 9 9 9 9 9 9 9 9 9 9 9 9 9 9 9 9 9 9 9 9 9 9 9 9 9 9 9 9 9 9 9 9 9 9 9 9 9 9 9 9 9 9 9 9 9 9 9 9 9 9 55 0 0 0 0 0 0 0 0 0 
9 9 9 9 9 9 9 9 9 55 55 55 55 55 55 55 55 55 55 55 55 55 55 55 55 55 55 55 55 55 55 55 55 55 55 55 55 55 55 55 55 55 55 55 55 55 55 55 55 55 55 55 55 55 55 55 55 55 55 55 55 0 0 0 0 0 0 0 0 0 
9 9 9 9 9 9 9 9 9 55 0 0 0 0 56 56 56 56 56 56 56 56 56 56 56 56 56 56 56 56 56 56 56 56 56 56 0 0 0 0 0 0 56 56 56 56 56 56 56 56 56 56 56 56 56 56 56 56 0 0 55 0 0 0 0 0 0 0 0 0 
9 9 9 9 9 9 9 9 9 55 0 0 0 0 56 2 2 2 2 2 2 2 2 2 2 2 2 2 2 2 2 2 2 2 2 56 0 0 0 0 0 0 56 2 2 2 2 2 2 2 2 2 2 2 2 2 2 56 0 0 55 0 0 0 0 0 0 0 0 0 
9 9 9 9 9 9 9 9 9 55 0 0 0 0 56 2 2 2 2 2 2 2 2 2 2 2 2 2 2 2 2 2 2 2 2 56 0 0 0 0 0 0 56 2 2 2 2 2 2 2 2 2 2 2 2 2 2 56 0 0 55 0 0 0 0 0 0 0 0 0 
9 9 9 9 9 9 9 9 9 55 0 0 0 0 56 2 2 2 2 2 2 2 2 2 2 2 2 2 2 2 2 2 2 2 2 56 56 56 56 56 56 56 56 2 2 2 2 2 2 2 2 2 2 2 2 2 2 56 0 0 55 0 0 0 0 0 0 0 0 0 
9 9 9 9 9 9 9 9 9 55 0 0 0 0 56 2 2 2 2 2 2 2 2 2 2 2 2 2 2 2 2 2 2 2 2 57 2 2 2 2 2 2 57 2 2 2 2 2 2 2 2 2 2 2 2 2 2 56 0 0 55 0 0 0 0 0 0 0 0 0 
9 9 9 9 9 9 9 9 9 55 0 0 0 0 56 2 2 2 2 2 2 2 2 2 2 2 2 2 2 2 2 2 2 2 2 56 0 0 2 2 0 0 56 2 2 2 2 2 2 2 2 2 2 2 2 2 2 56 0 0 55 0 0 0 0 0 0 0 0 0 
9 9 9 9 9 9 9 9 9 55 0 0 0 0 56 2 2 2 2 2 2 2 2 2 2 2 2 2 2 2 2 2 2 2 2 56 0 0 2 2 0 0 56 2 2 2 2 2 2 2 2 2 2 2 2 2 2 56 0 0 55 0 0 0 0 0 0 0 0 0 
9 9 9 9 9 9 9 9 9 55 0 0 0 0 56 56 56 56 56 56 56 56 56 56 56 57 56 56 56 56 56 56 56 56 56 56 0 0 2 2 0 0 56 56 56 56 56 56 56 57 56 56 56 56 56 56 56 56 0 0 55 0 0 0 0 0 0 0 0 0 
9 9 9 9 9 9 9 9 9 55 0 0 0 0 2 2 2 2 2 2 2 2 2 2 2 2 2 2 2 2 2 2 2 2 2 2 2 2 2 2 2 2 2 2 2 2 2 2 2 2 2 2 2 2 2 2 2 2 0 0 55 0 0 0 0 0 0 0 0 0 
9 9 9 9 9 9 9 9 9 55 0 0 0 0 2 2 2 2 2 2 2 2 2 2 2 2 2 2 2 2 2 2 2 2 2 2 2 2 2 2 2 2 2 2 2 2 2 2 2 2 2 2 2 2 2 2 2 2 0 0 55 0 0 0 0 0 0 0 0 0 
9 9 9 9 9 9 9 9 9 55 0 0 0 0 0 0 0 0 0 0 0 0 0 0 0 0 0 0 0 0 0 0 0 0 0 0 0 0 2 2 0 0 0 0 0 0 0 0 0 0 0 0 0 0 0 0 2 2 0 0 55 0 0 0 0 0 0 0 0 0 
9 9 9 9 9 9 9 9 9 55 0 0 0 0 0 0 0 56 56 56 56 56 56 56 56 57 56 56 56 56 56 56 56 56 56 56 56 0 2 2 0 0 0 0 0 0 0 0 0 0 0 0 0 0 0 0 2 2 0 0 55 0 0 0 0 0 0 0 0 0 
9 9 9 9 9 9 9 9 9 55 0 0 0 0 0 0 0 56 2 2 2 2 2 2 2 2 2 2 2 2 2 2 2 2 2 2 56 0 2 2 0 56 56 56 56 56 56 56 56 57 56 56 56 56 0 0 2 2 0 0 55 0 0 0 0 0 0 0 0 0 
9 9 9 9 9 9 9 9 9 9 9 9 9 0 0 0 0 56 2 2 2 2 2 2 2 2 2 2 2 2 2 2 2 2 2 2 56 0 2 2 0 56 2 2 2 2 2 2 2 2 2 2 2 56 0 0 2 2 0 0 55 0 0 0 0 0 0 0 0 0 
9 9 9 9 9 9 9 9 9 9 9 9 9 9 9 0 0 56 2 2 2 2 2 2 2 2 2 2 2 2 2 2 2 2 2 2 56 0 2 2 0 56 2 2 2 2 2 2 2 2 2 2 2 56 0 0 2 2 0 0 55 0 0 0 0 0 0 0 0 0 
9 9 9 9 9 9 9 9 9 9 9 9 9 9 9 0 0 56 2 2 2 2 2 2 2 2 2 2 2 2 2 2 2 2 2 2 57 0 2 2 0 56 2 2 2 2 2 2 2 2 2 2 2 56 0 0 2 2 0 0 55 0 0 0 0 0 0 0 0 0 
9 9 9 9 9 9 9 9 9 9 9 9 9 9 9 9 0 56 2 2 2 2 2 2 2 2 2 2 2 2 2 2 2 2 2 2 56 0 2 2 0 56 2 2 2 2 2 2 2 2 2 2 2 56 0 0 2 2 0 0 55 0 0 0 0 0 0 0 0 0 
9 9 9 9 9 9 9 9 9 56 56 9 9 9 9 9 9 56 2 2 2 2 2 2 2 2 2 2 2 2 2 2 2 2 2 2 56 0 2 2 0 56 2 2 2 2 2 2 2 2 2 2 2 56 0 0 2 2 0 0 55 0 0 0 0 0 0 0 0 0 
9 9 9 9 9 9 9 9 9 56 56 9 9 9 9 9 9 56 56 56 56 56 56 56 56 56 56 56 56 56 56 56 56 56 56 56 56 0 2 2 0 56 2 2 2 2 2 2 2 2 2 2 2 56 0 0 2 2 0 0 55 0 0 0 0 0 0 0 0 0 
9 9 9 9 9 9 9 9 9 9 9 9 9 9 9 9 9 0 0 0 0 52 52 0 0 0 0 0 0 0 0 0 0 0 52 0 0 0 2 2 0 56 2 2 2 2 2 2 2 2 2 2 2 56 0 0 2 2 0 0 55 0 0 0 0 0 0 0 0 0 
9 9 9 9 9 9 9 9 9 9 9 9 9 9 9 9 9 9 56 56 56 56 56 56 56 56 56 56 56 56 56 56 56 56 56 56 56 0 2 2 0 56 2 2 2 2 2 2 2 2 2 2 2 56 0 0 2 2 0 0 55 0 0 0 0 0 0 0 0 0 
9 9 9 9 9 9 9 9 9 9 9 9 9 9 9 9 9 9 2 2 2 2 2 2 2 56 2 2 2 2 2 2 2 2 2 2 56 0 2 2 0 56 2 2 2 2 2 2 2 2 2 2 2 56 0 0 2 2 0 0 55 0 0 0 0 0 0 0 0 0 
9 9 9 9 9 9 9 9 9 9 9 9 9 9 9 9 9 9 2 2 2 2 2 2 2 57 2 2 2 2 2 2 2 2 2 2 56 0 2 2 0 56 2 2 2 2 2 2 2 2 2 2 2 56 0 0 2 2 0 0 55 0 0 0 0 0 0 0 0 0 
9 9 9 9 9 9 9 9 9 9 9 9 9 9 9 9 9 9 9 9 9 9 2 2 2 56 2 2 2 2 2 2 2 2 2 2 56 0 2 2 0 56 2 2 2 2 2 2 2 2 2 2 2 56 0 0 2 2 0 0 55 0 0 0 0 0 0 0 0 0 
9 9 9 9 9 9 9 9 9 9 9 9 9 9 9 9 9 9 2 2 2 2 2 2 2 56 2 2 2 2 2 2 2 2 2 2 56 0 2 2 0 56 2 2 2 2 2 2 2 2 2 2 2 56 0 0 2 2 0 0 55 0 0 0 0 0 0 0 0 0 
9 9 9 9 9 9 9 9 9 9 9 9 9 9 9 9 9 9 2 2 2 2 2 2 2 56 2 2 2 2 2 2 2 2 2 2 56 0 2 2 0 56 56 56 56 56 56 57 56 56 56 56 56 56 0 0 2 2 0 55 55 0 0 0 0 0 0 0 0 0 
9 9 9 9 9 9 9 9 9 9 9 9 9 9 9 9 9 9 9 9 9 9 2 2 2 57 2 2 2 2 2 2 2 2 2 2 57 2 2 2 2 2 2 2 2 2 2 2 2 2 2 2 2 2 2 2 2 2 2 2 2 2 2 2 2 2 2 2 2 2 
9 9 9 9 9 9 9 9 9 9 9 9 9 9 9 9 9 9 2 2 2 2 2 2 2 56 2 2 2 2 2 2 2 2 2 2 56 0 2 2 0 56 56 56 56 56 56 57 56 56 56 56 56 56 52 0 2 2 2 2 2 2 2 2 2 2 2 2 2 2 
9 9 9 9 9 9 9 9 9 9 9 9 9 9 9 9 9 9 2 2 2 2 2 2 2 56 2 2 2 2 2 2 2 2 2 2 56 0 2 2 0 56 2 2 2 2 2 2 2 2 2 2 2 56 0 0 2 2 0 55 55 0 0 0 0 0 0 0 0 0 
9 9 9 9 9 9 9 9 9 9 9 9 9 9 9 9 9 9 9 9 9 9 2 2 2 56 2 2 2 2 2 2 2 2 2 2 56 0 2 2 0 56 2 2 2 2 2 2 2 2 2 2 2 56 0 0 2 2 0 0 55 0 0 0 0 0 0 0 0 0 
9 9 9 9 9 9 9 9 9 9 9 9 9 9 9 9 9 9 2 2 2 2 2 2 2 57 2 2 2 2 2 2 2 2 2 2 56 0 2 2 0 56 2 2 2 2 2 2 2 2 2 2 2 56 0 0 2 2 0 0 55 0 0 0 0 0 0 0 0 0 
9 9 9 9 9 9 9 9 9 9 9 9 9 9 9 9 9 9 2 2 2 2 2 2 2 56 2 2 2 2 2 2 2 2 2 2 56 0 2 2 0 56 2 2 2 2 2 2 2 2 2 2 2 56 0 0 2 2 0 0 55 0 0 0 0 0 0 0 0 0 
9 9 9 9 9 9 9 9 9 9 9 9 9 9 9 9 9 9 56 56 56 56 56 56 56 56 56 56 56 56 56 56 56 56 56 56 56 0 2 2 0 56 2 2 2 2 2 2 2 2 2 2 2 56 0 0 2 2 0 0 55 0 0 0 0 0 0 0 0 0 
9 9 9 9 9 9 9 9 9 9 9 9 9 9 9 9 9 0 0 0 0 0 0 0 0 0 0 0 0 0 0 0 0 0 0 0 0 0 2 2 0 56 2 2 2 2 2 2 2 2 2 2 2 56 0 0 2 2 0 0 55 0 0 0 0 0 0 0 0 0 
9 9 9 9 9 9 9 9 9 56 56 9 9 9 9 9 0 0 0 0 0 0 0 0 0 0 0 0 0 0 0 0 0 0 0 0 0 0 2 2 0 56 2 2 2 2 2 2 2 2 2 2 2 56 0 0 2 2 0 0 55 0 0 0 0 0 0 0 0 0 
9 9 9 9 9 9 9 9 9 56 56 9 9 9 9 0 0 0 0 0 0 0 0 0 0 0 0 0 0 0 0 0 0 0 0 0 0 0 2 2 0 56 56 56 56 56 56 56 56 56 56 56 56 56 0 0 2 2 0 0 55 0 0 0 0 0 0 0 0 0 
9 9 9 9 9 9 9 9 9 9 9 9 9 0 0 0 0 0 0 0 0 0 0 0 0 0 0 0 0 0 0 0 0 0 0 0 0 0 2 2 0 0 0 0 0 0 0 0 0 0 0 0 0 0 0 0 2 2 0 0 55 0 0 0 0 0 0 0 0 0 
9 9 9 9 9 9 9 9 9 9 9 0 0 0 0 0 0 0 0 0 0 0 0 0 0 0 0 0 0 0 0 0 0 0 0 0 0 0 2 2 0 0 0 0 0 0 0 0 0 0 0 0 0 0 0 0 2 2 0 0 55 0 0 0 0 0 0 0 0 0 
9 9 9 9 9 9 9 9 9 55 0 0 0 0 2 2 2 2 2 2 2 2 2 2 2 2 2 2 2 2 2 2 2 2 2 2 2 2 2 2 2 2 2 2 2 2 2 2 2 2 2 2 2 2 2 2 2 2 0 0 55 0 0 0 0 0 0 0 0 0 
9 9 9 9 9 9 9 9 9 55 0 0 0 0 2 2 2 2 2 2 2 2 2 2 2 2 2 2 2 2 2 2 2 2 2 2 2 2 2 2 2 2 2 2 2 2 2 2 2 2 2 2 2 2 2 2 2 2 0 0 55 0 0 0 0 0 0 0 0 0 
9 9 9 9 9 9 9 9 9 55 0 0 0 0 2 2 56 56 56 56 56 56 56 56 56 56 56 56 56 56 56 56 56 56 56 56 56 56 57 57 56 56 56 56 56 56 56 56 56 56 56 56 56 56 56 56 2 2 0 0 55 0 0 0 0 0 0 0 0 0 
9 9 9 9 9 9 9 9 9 55 0 0 0 0 2 2 56 2 2 2 2 2 2 2 2 2 2 2 2 2 2 2 2 2 2 2 2 2 2 2 2 2 2 2 2 2 2 2 2 2 2 2 2 2 2 56 2 2 0 0 55 0 0 0 0 0 0 0 0 0 
9 9 9 9 9 9 9 9 9 55 0 0 0 0 2 2 56 2 2 2 2 2 2 2 2 2 2 2 2 2 2 2 2 2 2 2 2 2 2 2 2 2 2 2 2 2 2 2 2 2 2 2 2 2 2 56 2 2 0 0 55 0 0 0 0 0 0 0 0 0 
9 9 9 9 9 9 9 9 9 55 0 0 0 0 2 2 56 2 2 2 2 2 2 2 2 2 2 2 2 2 2 2 2 2 2 2 2 2 2 2 2 2 2 2 2 2 2 2 2 2 2 2 2 2 2 56 2 2 0 0 55 0 0 0 0 0 0 0 0 0 
9 9 9 9 9 9 9 9 9 55 0 0 0 0 2 2 56 2 2 2 2 2 2 2 2 2 2 2 2 2 2 2 2 2 2 2 2 2 2 2 2 2 2 2 2 2 2 2 2 2 2 2 2 2 2 56 2 2 0 0 55 0 0 0 0 0 0 0 0 0 
9 9 9 9 9 9 9 9 9 55 0 0 0 0 2 2 56 2 2 2 2 2 2 2 2 2 2 2 2 2 2 2 2 2 2 2 2 2 2 2 2 2 2 2 2 2 2 2 2 2 2 2 2 2 2 56 2 2 0 0 55 0 0 0 0 0 0 0 0 0 
9 9 9 9 9 9 9 9 9 55 0 0 0 0 2 2 56 2 2 2 2 2 2 2 2 2 2 2 2 2 2 2 2 2 2 2 2 2 2 2 2 2 2 2 2 2 2 2 2 2 2 2 2 2 2 56 2 2 0 0 55 0 0 0 0 0 0 0 0 0 
9 9 9 9 9 9 9 9 9 55 0 0 0 0 2 2 56 2 2 2 2 2 2 2 2 2 2 2 2 2 2 2 2 2 2 2 2 2 2 2 2 2 2 2 2 2 2 2 2 2 2 2 2 2 2 56 2 2 0 0 55 0 0 0 0 0 0 0 0 0 
9 9 9 9 9 9 9 9 9 55 0 0 0 0 2 2 56 56 56 56 56 56 56 56 56 56 56 56 56 56 56 56 56 56 56 56 56 56 56 56 56 56 56 56 56 56 56 56 56 56 56 56 56 56 56 56 2 2 0 0 55 0 0 0 0 0 0 0 0 0 
9 9 9 9 9 9 9 9 9 55 0 0 0 0 2 2 2 2 2 2 2 2 2 2 2 2 2 2 2 2 2 2 2 2 2 2 2 2 2 2 2 2 2 2 2 2 2 2 2 2 2 2 2 2 2 2 2 2 0 0 55 0 0 0 0 0 0 0 0 0 
9 9 9 9 9 9 9 9 9 55 0 0 0 0 2 2 2 2 2 2 2 2 2 2 2 2 2 2 2 2 2 2 2 2 2 2 2 2 2 2 2 2 2 2 2 2 2 2 2 2 2 2 2 2 2 2 2 2 0 0 55 0 0 0 0 0 0 0 0 0 
9 9 9 9 9 9 9 9 9 55 56 56 56 56 56 56 56 56 56 56 56 56 56 56 56 56 56 56 56 56 56 56 56 56 56 56 56 56 56 56 56 56 56 56 56 56 56 56 56 56 56 56 56 56 56 56 56 56 0 0 55 0 0 0 0 0 0 0 0 0 
9 9 9 9 9 9 9 9 9 55 56 0 0 0 56 0 0 0 0 0 0 0 0 0 0 0 0 0 0 0 0 0 0 0 0 0 0 0 0 0 0 0 0 0 0 0 0 0 0 0 0 0 0 0 0 0 0 56 0 0 55 0 0 0 0 0 0 0 0 0 
9 9 9 9 9 9 9 9 9 55 56 0 0 0 56 0 0 0 0 0 0 0 0 0 0 0 0 0 0 0 0 0 0 0 0 0 0 0 0 0 0 0 0 0 0 0 0 0 0 0 0 0 0 0 0 0 0 56 0 0 55 0 0 0 0 0 0 0 0 0 
9 9 9 9 9 9 9 9 9 55 56 0 0 0 56 0 0 0 0 0 0 0 0 0 0 0 0 0 0 0 0 0 0 0 0 0 0 0 0 0 0 0 0 0 0 0 0 0 0 0 0 0 0 0 0 0 0 56 0 0 55 0 0 0 0 0 0 0 0 0 
9 9 9 9 9 9 9 9 9 55 56 0 0 0 56 0 0 0 0 0 0 0 0 0 0 0 0 0 0 0 0 0 0 0 0 0 0 0 0 0 0 0 0 0 0 0 0 0 0 0 0 0 0 0 0 0 0 56 0 0 55 0 0 0 0 0 0 0 0 0 
9 9 9 9 9 9 9 9 9 55 56 0 0 0 56 0 0 0 0 0 0 0 0 0 0 0 0 0 0 0 0 0 0 0 0 0 0 0 0 0 0 0 0 0 0 0 0 0 0 0 0 0 0 0 0 0 0 56 0 0 55 0 0 0 0 0 0 0 0 0 
9 9 9 9 9 9 9 9 9 55 56 0 0 0 56 0 0 0 0 0 0 0 0 0 0 0 0 0 0 0 0 0 0 0 0 0 0 0 0 0 0 0 0 0 0 0 0 0 0 0 0 0 0 0 0 0 0 56 0 0 55 0 0 0 0 0 0 0 0 0 
9 9 9 9 9 9 9 9 9 55 56 0 0 0 56 0 0 0 0 0 0 0 0 0 0 0 0 0 0 0 0 0 0 0 0 0 0 0 0 0 0 0 0 0 0 0 0 0 0 0 0 0 0 0 0 0 0 56 0 0 55 0 0 0 0 0 0 0 0 0 
9 9 9 9 9 9 9 9 9 55 56 56 56 56 56 56 56 56 56 56 56 56 56 56 56 56 56 56 56 56 56 56 56 56 56 56 56 56 56 56 56 56 56 56 56 56 56 56 56 56 56 56 56 56 56 56 56 56 0 0 55 0 0 0 0 0 0 0 0 0 
9 9 9 9 9 9 9 9 9 55 55 55 55 55 55 55 55 55 55 55 55 55 55 55 55 55 55 55 55 55 55 55 55 55 55 55 55 55 55 55 55 55 55 55 55 55 55 55 55 55 55 55 55 55 55 55 55 55 55 55 55 0 0 0 0 0 0 0 0 0 
9 9 9 9 9 9 9 9 9 9 9 9 9 9 9 9 9 9 9 9 9 9 9 9 9 9 9 9 9 9 9 9 9 9 9 9 9 9 9 9 9 9 9 9 9 9 9 9 9 9 9 9 9 9 9 9 9 9 9 9 55 0 0 0 0 0 0 0 0 0 
9 9 9 9 9 9 9 9 9 9 9 9 9 9 9 9 9 9 9 9 9 9 9 9 9 9 9 9 9 9 9 9 9 9 9 9 9 9 9 9 9 9 9 9 9 9 9 9 9 9 9 9 9 9 9 9 9 9 9 9 55 0 0 0 0 0 0 0 0 0 
9 9 9 9 9 9 9 9 9 9 9 9 9 9 9 9 9 9 9 9 9 9 9 9 9 9 9 9 9 9 9 9 9 9 9 9 9 9 9 9 9 9 9 9 9 9 9 9 9 9 9 9 9 9 9 9 9 9 9 9 55 0 0 0 0 0 0 0 0 0 
9 9 9 9 9 9 9 9 9 9 9 9 9 9 9 9 9 9 9 9 9 9 9 9 9 9 9 9 9 9 9 9 9 9 9 9 9 9 9 9 9 9 9 9 9 9 9 9 9 9 9 9 9 9 9 9 9 9 9 9 55 0 0 0 0 0 0 0 0 0 
9 9 9 9 9 9 9 9 9 9 9 9 9 9 9 9 9 9 9 9 9 9 9 9 9 9 9 9 9 9 9 9 9 9 9 9 9 9 9 9 9 9 9 9 9 9 9 9 9 9 9 9 9 9 9 9 9 9 9 9 55 0 0 0 0 0 0 0 0 0 
9 9 9 9 9 9 9 9 9 9 9 9 9 9 9 9 9 9 9 9 9 9 9 9 9 9 9 9 9 9 9 9 9 9 9 9 9 9 9 9 9 9 9 9 9 9 9 9 9 9 9 9 9 9 9 9 9 9 9 9 55 0 0 0 0 0 0 0 0 0 
9 9 9 9 9 9 9 9 9 9 9 9 9 9 9 9 9 9 9 9 9 9 9 9 9 9 9 9 9 9 9 9 9 9 9 9 9 9 9 9 9 9 9 9 9 9 9 9 9 9 9 9 9 9 9 9 9 9 9 9 55 0 0 0 0 0 0 0 0 0 
9 9 9 9 9 9 9 9 9 9 9 9 9 9 9 9 9 9 9 9 9 9 9 9 9 9 9 9 9 9 9 9 9 9 9 9 9 9 9 9 9 9 9 9 9 9 9 9 9 9 9 9 9 9 9 9 9 9 9 9 55 0 0 0 0 0 0 0 0 0 
9 9 9 9 9 9 9 9 9 9 9 9 9 9 9 9 9 9 9 9 9 9 9 9 9 9 9 9 9 9 9 9 9 9 9 9 9 9 9 9 9 9 9 9 9 9 9 9 9 9 9 9 9 9 9 9 9 9 9 9 55 0 0 0 0 0 0 0 0 0 
9 9 9 9 9 9 9 9 9 9 9 9 9 9 9 9 9 9 9 9 9 9 9 9 9 9 9 9 9 9 9 9 9 9 9 9 9 9 9 9 9 9 9 9 9 9 9 9 9 9 9 9 9 9 9 9 9 9 9 9 55 0 0 0 0 0 0 0 0 0 
